BBBBBBBB
BBBFBBBF
FBBBFBFB
BFBBBBBF
BBBBBBBB
BBBBBBFF