PFFFFFFF
BBBBBBBB
FFFFFFFF
BBBBBBBB
FFFFFFFF
BBBBBBBE