PBFBFBFB
BFBFBFBF
FBFBFBFB
BFBFBFBF
FBFBFBFE
BFBFBFBF