PFFBBFFF
FFBBBBFF
FBBBBBBF
FBBBEBBF
FFBBBBFF
FFFBBFFF