PBFBFBFB
FBFBFBFB
FBFBFBFB
FBFBFBFB
FBFBFBFB
FBFBFBFE